13,07

######!######
##?   D   ?##
#? #     # ?#
# # B   B # #
#  B  P  B  #
#   #   #   #
#############