13
07

WWWWWWEWWWWWW
WWH   D   HWW
WH W     W HW
W W B   B W W
W  B  P  B  W
W   W   W   W
WWWWWWWWWWWWW