#####################
##!### ?        # #?#
# D     ##  # #B#   #
#        #  #B    # #
# P  #      # ##  # #
#?#  ##  #     # B# #
########### # B#    #
          #       # #
          ### ####  #
          #        ##
          ##       ?#
          ###########